--W--TW--D--TWT-----
--W---W------W--W---
--W---WW----WW--W---
-RW-------------W---
----------------WR--
---W--W---------W---
-B-W--W---------W---
---W--W---------W-B-
---W--WWWWWWWWWWW---
-T-W----------------
WWWW----B-----------
---WWWWWW--WWWWWWWWW
-------------------T
--------R-----------
-------------WWWWWW-
-------------W------
---R---------W------
-------------W------
----------R---------
------R--P----------