------W--D---------T
------W---------W---
------W--T---R--WW--
------WW---------W--
WWWWW--W---------W--
---TW--W---------W--
----WWWW---------W--
----------R------W--
-B---------------W--
----WWWW---WWWWWWW--
---TWR-----------R--
--WWW---------------
--W-----W--WWW------
--W---WWW---TW--R---
--W---W--B---W------
--W---W------W------
--W-T-W-------B----T
--WWWWW------WWWWWWW
--------------------
---------P----------