---------D----------
--WWWWW-----WWWWW---
--W-T-W--T--W-T-W---
--W---W-----W---W---
--W---W-----W---W---
--W---WWW-WWW---W---
--W------T------W---
--W---R-----R---W---
--WWW---------WWW---
---------R----------
--------------------
--WWWW-------WWWW---
--W-TW-------WT-W---
--W---W-----W---W---
--W----W---W----W---
--W-------------W---
---W-----------W----
----WWWW---WWWW-----
--------------------
RR-------P--------RR